6 5
WWWWWW
WS...W
W....W
W...TW
WWWWWW
