12 16
WWWWWWWWWWWW
WWW...WWW.WW
WW.....WW.WW
WW.W.WWW...W
WW..W..WWW.W
WWW.WWW.WW.W
WT....W.WW.W
WWWWSWWWW..W
WWWW..WWW..W
W.TW.WWWW.WW
W.WW.WWWW..W
W.WW.WWW.W.W
W.WW..W....W
W..WW..W.WWW
WW.......WWW
WWWWWWWWWWWW

